6

6

4

-1 1 1 1 1 -1
1 -1 -1 -1 -1 1
1 -1 -1 -1 -1 1
1 1 1 1 1 1
1 -1 -1 -1 -1 1
1 -1 -1 -1 -1 1

1 1 1 1 1 -1
1 -1 -1 -1 -1 1
1 -1 -1 -1 -1 1
1 1 1 1 1 -1
1 -1 -1 -1 -1 1
1 1 1 1 1 -1

-1 1 1 1 1 1
1 -1 -1 -1 -1 -1
1 -1 -1 -1 -1 -1
1 -1 -1 -1 -1 -1
1 -1 -1 -1 -1 -1
-1 1 1 1 1 1

1 1 1 1 -1 -1
1 -1 -1 -1 1 -1
1 -1 -1 -1 -1 1
1 -1 -1 -1 -1 1
1 -1 -1 -1 1 -1
1 1 1 1 -1 -1

-1 1 1 -1 -1 1
1 -1 1 1 -1 -1
-1 1 1 -1 -1 1
1 1 1 1 -1 -1
1 -1 -1 1 1 1
1 -1 -1 1 -1 1
